NO textures/SO.xpm
SO textures/SO.xpm
WE textures/SO.xpm
EA textures/SO.xpm

F 10,100,10
C 10,10,100

1111111111111111111111111
110000100000000100000D0W1
1101111011111101011111101
1101001010000000000000101
11011110100000001111101D1
1101001010000010010100101
1100001000000010010100101
1000001100000001010100101
1100001000000010000000101
1100001000000010001000101
1101111011111110001010001
1100001000100000000010101
1101110000000000010100001
1100011000111011111110101
1100011000100010000000101
1000010000100010100010101
1111011110100000101010011
1111011110101000101010101
1111001110001010101010101
1011010110101010101010101
1010010100101010001010101
1010000100001011111010101
1010110101011000000010101
1010100101001111111010101
1010100101000000000010001
1111111111111111111111111
