NO 	textures/NO.xpm
SO 	textures/SO.xpm
WE 	textures/WE.xpm
EA 	textures/EA.xpm




F 	221,110,0
C 	225,30,0


               
   111111111   
   100000001   
   100000001   
   100000001   
   100001001   
   100010001   
   100000001   
   100N00001   
   111111111   
               
