

NO 	textures/NO.xpm
SO 	textures/SO.xpm
WE 	textures/WE.xpm
EA 	textures/EA.xpm

F 	54,16,16
C 	50,50,50


1111111111111111111111111
1000100010000000000000011
1000D000D0001000000000011
100011D110N0D000000000011
1000000000001000000000011
1000000000000000000000011
1111111111111111111111111