NO 	textures/NO.xpm
SO 	textures/SO.xpm
WE 	textures/WE.xpm
EA 	textures/EA.xpm




F 	221,110,0
C 	225,30,0


                
   1111111111   
   1000000001    
   1000000001    
   100N000001   
   1000100011   
   1000000001   
   1000000001   
   1111111111   
                