NO 	textures/NO.xpm
SO 	textures/SO.xpm
WE 	textures/WE.xpm
EA 	textures/EA.xpm




F 	221,110,0
C 	225,30,0


                
   1111111111   
   1000000001    
   1000000001    
   10E0010001   
   1000100001   
   1000000001   
   1000000001   
   1111111111   
                