NO 	textures/NO.xpm
SO 	textures/SO.xpm
WE 	textures/WE.xpm
EA 	textures/EA.xpm




F 	221,110,0
C 	225,30,0


                                                          
   1111111111111111111111111111111111111111111111111111   
   1001001001001001001001001001000000000000000000000001   
   1001001001001001001001001001000001010101010101010101   
   1000000000000000000000000000000N00000000000000000011   
   1001001001001001001001001001000001010101010101010101   
   1000000000000000000000000000000000000000000000000001   
   1000000000000000000000000000000000000000000000000001   
   1111111111111111111111111111111111111111111111111111   
                                                          