NO 	textures/NO.xpm
SO 	textures/SO.xpm
WE 	textures/WE.xpm
EA 	textures/EA.xpm




F 	221,110,0
C 	225,30,0


            
   111111   
   101001   
   100001   
   100001   
   10N001   
   100101   
   100001   
   101001   
   111111   
            