NO 	textures/NO.xpm
SO 	textures/SO.xpm
WE 	textures/WE.xpm
EA 	textures/EA.xpm




F 	221,110,0
C 	225,30,0


                  
   111111111111   
   100000000001   
   100001000001   
   100010000001   
   1001N1000001   
   100010000001   
   100000000001   
   100000000001   
   111111111111   
                  
