NO 	textures/NO.xpm
SO 	textures/SO.xpm
WE 	textures/WE.xpm
EA 	textures/EA.xpm




F 	221,110,0
C 	225,30,0


                                                      
   111111111111111111111111111111111111111111111111   
   101000000000000000000000000000000000000000000001   
   100000000000000000000000000000000000000000000001   
   100000000000000000000000000000000000000000000001   
   100000000000000000000000000000000000000000000001   
   100000000000000000000000000000000000000000000001   
   100000000000000000000000000000000000000000000001   
   100000000000000000000000000000000000000000000001   
   10N000000000000000000000000000000000000000000001   
   100101010101010101010101010101010101010101010101   
   100000000000000000000000000000000000000000000001   
   100000000000000000000000000000000000000000000001   
   100000000000000000000000000000000000000000000001   
   100000000000000000000000000000000000000000000001   
   101000000000000000000000000000000000000000000001   
   111111111111111111111111111111111111111111111111   
                                                      