NO 	textures/SO.xpm
SO 	textures/SO.xpm
WE 	textures/SO.xpm
EA 	textures/SO.xpm


F 	199,169,0
C 	41,159,255

      1111111
1111111N00011
1111111000011
1111111000011
1111111111111