NO 	textures/NO.xpm
SO 	textures/SO.xpm
WE 	textures/WE.xpm
EA 	textures/EA.xpm




F 	221,110,0
C 	225,30,0


                  
   111111111111   
   100100000001   
   100100000101   
   1000000N0011   
   100000000101   
   100000000001   
   100000000001   
   111111111111   
                  