NO 	textures/NO.xpm
SO 	textures/SO.xpm
WE 	textures/WE.xpm
EA 	textures/EA.xpm



F 	54,16,16
C 	50,50,50

                                            
   11111111111111111111111111111111111111   
   1000000000000000000000E000000000000011   
   10000000000000000000000000000000000011   
   10000000000000000000000000000000000011   
   1D1D1D1D1D1D1D1D1D1D1D1D1D1D1D1D1D1D11   
   10000000000000000000000000000000000011   
   1D1D1D1D1D1D1D1D1D1D1D1D1D1D1D1D1D1D11   
   1D1D1D1D1D1D1D1D1D1D1D1D1D1D1D1D1D1D11   
   1D1D1D1D1D1D1D1D1D1D1D1D1D1D1D1D1D1D11   
   10000000000000000000000000000000000011   
   1D1D1D1D1D1D1D1D1D1D1D1D1D1D1D1D1D1D11   
   10000000000000000000000000000000000011   
   1D1D1D1D1D1D1D1D1D1D1D1D1D1D1D1D1D1D11   
   10000000000000000000000000000000000011   
   1D1D1D1D1D1D1D1D1D1D1D1D1D1D1D1D1D1D11   
   1D1D1D1D1D1D1D1D1D1D1D1D1D1D1D1D1D1D11   
   10000000000000000000000000000000000011   
   10000000000000000000000000000000000011   
   10000000000000000000000000000000000011   
   10000000000000000000000000000000000011   
   11111111111111111111111111111111111111   
                                            