NO 	textures/NO.xpm
SO 	textures/SO.xpm
WE 	textures/WE.xpm
EA 	textures/EA.xpm




F 	221,110,0
C 	225,30,0


                                            
   11111111111111111111111111111111111111   
   10000000000000000000000000000000000011   
   10101010101010101010101010101010101011   
   10000000000000000000000000000000000011   
   10101010101010101010101010101010101011   
   10000000000000000000000000000000000011   
   10101010101010101010101010101010101011   
   10000000000000000000000000000000000011   
   10101010101010101010101010101010101011   
   10000000000000000000000000000000000011   
   10101010101010101010101010101010101011   
   10000000000000000000000000000000000011   
   101010101010101010101010101N1010101011   
   10000000000000000000000000000000000011   
   11111111111111111111111111111111111111   
                                            