NO 	textures/NO.xpm
SO 	textures/SO.xpm
WE 	textures/WE.xpm
EA 	textures/EA.xpm




F 	221,110,0
C 	225,30,0


                                            
   11111111111111111111111111111111111111   
   1000000000000000000000N000000000000011   
   10000000000000000000000000000000000011   
   10000000000000000000000000000000000011   
   1D1D1D1D1D1D1D1D1D1D1D1D1D1D1D1D1D1D11   
   1000D000D00000000000000000000000000011   
   1D1D1D1D1D1D1D1D1D1D1D1D1D1D1D1D1D1D11   
   1D1D1D1D1D1D1D1D1D1D1D1D1D1D1D1D1D1D11   
   1D1D1D1D1D1D1D1D1D1D1D1D1D1D1D1D1D1D11   
   10000000000000000000000000000000000011   
   1D1D1D1D1D1D1D1D1D1D1D1D1D1D1D1D1D1D11   
   10000000000000000000000000000000000011   
   1D1D1D1D1D1D1D1D1D1D1D1D1D1D1D1D1D1D11   
   10000000000000000000000000000000000011   
   1D1D1D1D1D1D1D1D1D1D1D1D1D1D1D1D1D1D11   
   1D1D1D1D1D1D1D1D1D1D1D1D1D1D1D1D1D1D11   
   10000000000000000000000000000000000011   
   10000000000000000000000000000000000011   
   10000000000000000000000000000000000011   
   10000000000000000000000000000000000011   
   11111111111111111111111111111111111111   
                                            