NO textures/NO.xpm
SO textures/SO.xpm
WE textures/WE.xpm
EA textures/EA.xpm

F 221,110,0
C 225,30,0

11111111111111111111111111111111111111111111111111111111111111111111111111111111111111111111111
100000000000000000000000000000000000000000000000000000000000000000000000000010000000010000000N1
10000000000000000000000000000000000000000000000000000000000000000000000000001011111101000000101
10000000000000000000000000000000000000000000000000000000000000000000000000001010000000000000101
10000000000000000000000000000000000000000000000000000000000000000000000000001010000000000000101
10000000000000000000000000000000000000000000000000000000000000000000000000001010000010000000101
10000000000000000000000000000000000000000000000000000000000000000000000000001000000010000000101
10000000000000000000000000000000000000000000000000000000000000000000000000001000000010000000101
10000000000000000000000000000000000000000000000000000000000000000000000000001000000010000000101
10000000000000000000000000000000000000000000000000000000000000000000000000001000000010000000101
10000000000000000000000000000000000000000000000000000000000000000000000000001011111110000010001
10000000000000000000000000000000000000000000000000000000000000000000000000001000000000000010101
10000000000000000000000000000000000000000000000000000000000000000000000000001000000000000010101
10000000000000000000000000000000000000000000000000000000000000000000000000001000111111111110101
10000000000000000000000000000000000000000000000000000000000000000000000000001000100010000000101
10000000000000000000000000000000000000000000000000000000000000000000000000000000100010100010101
10000000000000000000000000000000000000000000000000000000000000000000000000001110100000101010011
10000000000000000000000000000000000000000000000000000000000000000000000000001110101000101010101
10000000000000000000000000000000000000000000000000000000000000000000000000001110001010101010101
10000000000000000000000000000000000000000000000000000000000000000000000000000110101010101010101
10000000000000000000000000000000000000000000000000000000000000000000000000000100101010001010101
10000000000000000000000000000000000000000000000000000000000000000000000000000100001011111010101
10000000000000000000000000000000000000000000000000000000000000000000000000000101111000000010101
10000000000000000000000000000000000000000000000000000000000000000000000000000101001111111010101
10000000000000000000000000000000000000000000000000000000000000000000000000000101000000000010001
11111111111111111111111111111111111111111111111111111111111111111111111111111111111111111111111
