NO textures/NO.xpm
SO textures/SO.xpm
WE textures/WE.xpm
EA textures/EA.xpm

F 221,110,0
C 225,30,0

1111111111
1E00010001
1000001101
1001101001
1001001001
1001001001
1001011001
1000000001
1000000001
1111111111