NO textures/NO.xpm
SO textures/SO.xpm
WE textures/WE.xpm
EA textures/EA.xpm

F 	54,16,16
C 	50,50,50

1111111111111111111111111111111111111111111111
1010101010101010101010101010101010101010101011
1000000000000000000000E00000000010000000000001
1000100000000000000000000000000000000000000001
1000100000000000000000000000000000000000000001
1000100000000000000000000000000010000000000001
1000100000000010101010101010101010100010101011
1000100000000010001000100010001010000000101011
1000100000000010000000000000001010000000000001
1000100000000000000000000000000000000000101011
1000100000000010000000000000001010000000000001
1000000000000010000000000000001010000000101011
1000000000000010101010001010101010101010101011
1010101010101010101010001010101010101010101011
1000000000000000000000000000000000000000000001
1010101010100010101010001010101010101010101011
1010101010100010101010001010101010101010101011
1000000000000000001010001010000000000010000001
1000000000000000000000001010000010000010000001
1000000000000000001010001010000000000010100011
1000100010000000001010000000000010000000000001
1000001000000000001010001010000000000010100011
1000100010000000001010001010000010000010000001
1000000000000000001010001010000000000010000001
1010101010101010101010101010101010101010101011
1111111111111111111111111111111111111111111111