NO 	textures/NO.xpm
SO 	textures/SO.xpm
WE 	textures/WE.xpm
EA 	textures/EA.xpm




F 	1,2,3
C 	4,10,10




                  
      111111      
     10000001     
    1000000001    
   100000000001
  100000N0000001  
   100000000001   
    1000000001    
     10000001     
      111111      
                  
