NO 	textures/NO.xpm
SO 	textures/SO.xpm
WE 	textures/WE.xpm
EA 	textures/EA.xpm




F 	1,2,3
C 	4,10,10



 
111N11
100001
111111