NO      textures/NO.xpm
SO      textures/SO.xpm
WE      textures/WE.xpm
EA      textures/EA.xpm




F 220,100,0
C 225,30,0


111111111111111111111111111111111111111
110000000000000000000000000000000000011
110000000000000000000000000000000000011
110000000000000000000000000000000000011
110000000000000000010000000000000000011
110000000000000000000000000000000000011
110000000000000000000000000000000000011
1100000000000000000N0000000000000000011
110000000100000000000000000000000000011
110000000000000000100000000000000000011
110000000000000000000000000000000000011
110000000000000000000000000000000000011
110000000100000000000000000000000000011
111111111111111111111111111111111111111