NO 	textures/NO.xpm
SO 	textures/SO.xpm
WE 	textures/WE.xpm
EA 	textures/EA.xpm




F 	1,2,3
C 	4,10,10




111111111111111111
      111111111111
     1000000111111
    10000000011111
   100000000000000
11100000N000000011
   1000000000011  
    1000000001    
     10000001     
11111110000111111 
      10001       
      1001        
    11101         
111111111111111111