            NO               textures/NO.xpm
            SO               textures/	 .xpm
                         WE               textures/WE.xpm
                           EA               textures/EA.xpm

   F    1,2,3
   C     4,10,10






111111111111111
10000000000000001
100000000000001
100000010000001
100000000000001
100000000000001
100000000000001
111111111111111
