NO 	textures/NO.xpm
SO 	textures/SO.xpm
WE 	textures/WE.xpm
EA 	textures/EA.xpm




F 220,100,10
C 225,30,10


        111111111111111111111111111111
        100000000011000000000000100001
        101100000111000000000000100001
        100100000000000000000000100001
11111111101100000111000000000000000001
10000000001100000111011101111111100001
11110111111111011100000010000000000001
11110111111111011101010010000000000001
11000000110101011100000010000000000001
10000000000000001100000010000000000001
10000000000000001101010010000000000001
11000001110101011111011110N01111111111
11110111 1110101 101111010001
11111111 1111111 111111111111