
NO /dev/urandom
SO textures/SO.xpm
WE textures/WE.xpm
EA textures/EA.xpm







F 1,2,3
C 4,5,6







        1111111111 11111111111111
        100000000111000000000000111
        11110000011100000000000111
        11110000000000000000000111
1111111111111111111111111111111111
1000000000110000011101111111111111
11110111111111011100000010001111111
11110111111111011101010010001111111
11000000110101011100000010001111111
10000000000000001100000010001
10000000000000001101010010001
110000N111010100011101111000111
11110111 1110101 101111010001
11111111111111111111111 1000111 111
