NO 	textures/NO.xpm
SO 	textures/SO.xpm
WE 	textures/WE.xpm
EA 	textures/EA.xpm




F 	1,2,3
C 4,10,10


111111
111101
111111
11N111