NO 	textures/NO.xpm
SO 	textures/SO.xpm
WE 	textures/WE.xpm
EA 	textures/EA.xpm




F 	221,110,0
C 	225,30,0


        11111111111111111111111111111111111111111111111111111111111111111
        10000000001100000000000010000000000000000000000000000000000000001
        1011000001110000000000001000000000000000100000000000000000000001
        10010000000000000000000010000000000000000000000000000000000000001
1111111110110000011100000000000010000000000000000000000000000000000000001
1000000000110000011101111111111110000000000000000000000000000000000000001
1111011111111101110000001000100000000000000000111111111111111111111111111
11110111111111011101010010001000000000000000001
11000000110101011100000010001000000000000000001
10000000000000001100000010001000000000000000001
1000000000000000110101001000100000000000000000111
11000001110101011111011110N0111000000000000000001
11110111 1110101 10111101000100000000000000000111
11111111 1111111 111111111111111111111111111111
111111
111111
111111
111111