NO 	textures/NO.xpm
SO 	textures/SO.xpm
WE 	textures/WE.xpm
EA 	textures/EA.xpm




F 	199,169,1
C 	41,159,255





1111111111
1000000001
1000E00101
1000001001
1111111111
