            NO               textures/NO.xpm
            SO               textures/SO.xpm
            WE               textures/WE.xpm
            EA               textures/EA.xpm

   F  1,2,3
   C     4,10,10

                                
        1111111111 11111111111111
        100000000111000000000000111
        11110000011100000000000111
        11110000000000000000000111
1111111111111111111111111111111111
100000000011001111111111
111
11110111111111011100000010001111111
11110111111111010010001111111
11000000110101011100000010001111111
10000000000000000010001
110000N111010100011101111000111
11110111 1110101 101111010000000001
11111111111111111111111 1000111 111
