NO 	textures/NO.xpm
SO 	textures/SO.xpm
WE 	textures/WE.xpm
EA 	textures/EA.xpm




F 	1,2,3
C 4,10,10




111 111111111111111
111 110000001111111
111 110000000111111
111 110000000000001
111 110000000000111
1111110000000011  1
10000000000001    1
1111010000001     1
11110110000111111 1
11110110001       1
1111011001        1
111101101         1
1111111111111111111