NO 	textures/NO.xpm
SO 	textures/SO.xpm
WE 	textures/WE.xpm
EA 	textures/EA.xpm



F 	54,16,16
C 	50,50,50





1111111111
1000000001
1000E00001
1000000001
1111111111
