NO 	textures/NO.xpm
SO 	textures/SO.xpm
WE 	textures/WE.xpm
EA 	textures/EA.xpm


F 	54,16,16
C 	50,50,50


111111111111111111111
110000100000000000001
101111111110111011101
100000001010100000101
111010101011101011111
101010100000001010101
101111101111111110101
100010001000100000001
101110111110101110111
100000000000100010101
101010111111101011101
101010000000101000001
101010101111111010111
101010100010000010001
111011101111111011111
100000100010001000101
101111101111101011101
100000101000001000001
101111101110101011111
100010000000100000E11
111111111111111111111