NO 	textures/NO.xpm
SO 	textures/SO.xpm
WE 	textures/WE.xpm
EA 	textures/EA.xpm


F 	199,169,0
C 	41,159,255

111111111111
100000000001
100000N00001
100000000001
111111111111