NO 	textures/SO.xpm
SO 	textures/SO.xpm
WE 	textures/SO.xpm
EA 	textures/SO.xpm


F 	199,169,0
C 	41,159,255

 111111 
11EO0001 
111101    
  11111   