NO 	textures/NO.xpm
SO 	textures/SO.xpm
WE 	textures/SO.xpm
EA 	textures/NO.xpm


F 	199,169,0
C 	41,159,255

111111111111111111111111
100000000000000000100001
100000000000100000000001
100001D100E0D00000000001
100000000000100000000001
100000000000000000100001
111111111111111111111111
