NO 	textures/NO.xpm
SO 	textures/SO.xpm
WE 	textures/WE.xpm
EA 	textures/EA.xpm


F 	199,169,0
C 	20,20,20

1111111111111111111111111
1000000000000000000000011
1000000000001000000000011
100001D100E0D000000000011
1000000000001000000000011
1000000000000000000000011
1111111111111111111111111
