NO 	textures/NO.xpm
SO 	textures/NO.xpm
WE 	textures/NO.xpm
EA 	textures/NO.xpm


F 	0,0,0
C 	50,50,50

1111111111111111111111111
1000100010000000000000011
1000100010001000000000011
100001D100E0D000000000011
1000000000001000000000011
1000000000000000000000011
1111111111111111111111111
