NO 	textures/SO.xpm
SO 	textures/exit_selected.xpm
WE 	textures/SO.xpm
EA 	textures/SO.xpm


F 	199,169,0
C 	41,159,255

11111111
10010001
100D0001
10010E01
11111111
