NO 	textures/SO.xpm
SO 	textures/SO.xpm
WE 	textures/SO.xpm
EA 	textures/SO.xpm


F 	199,169,0
C 	41,159,255

111111111111111
100100000000101
100000010100001
10010E000000101
111111111111111
