NO 	textures/SO.xpm
SO 	textures/exit_selected.xpm
WE 	textures/SO.xpm
EA 	textures/SO.xpm


F 	199,169,0
C 	41,159,255

  111111    
  10E001   
  11D101    
  100001    
  111111    