NO 	textures/SO.xpm
SO 	textures/exit_selected.xpm
WE 	textures/SO.xpm
EA 	textures/SO.xpm


F 	199,169,0
C 	41,159,255

11111111111111111
10000000000010001
100001D10000D0001
10000000000010E01
11111111111111111
