NO 	textures/SO.xpm
SO 	textures/exit_selected.xpm
WE 	textures/SO.xpm
EA 	textures/SO.xpm


F 	199,169,0
C 	41,159,255

11111111111
10000E00001
10000000001
10001D10001
10000000001
11111111111
