NO 	textures/NO.xpm
SO 	textures/SO.xpm
WE 	textures/WE.xpm
EA 	textures/EA.xpm


F 	199,169,0
C 	41,159,255

11111111111111111
10000000000010001
100001D100E0D0001
10000000000010001
11111111111111111
