NO 	textures/SO.xpm
SO 	textures/SO.xpm
WE 	textures/SO.xpm
EA 	textures/SO.xpm


F 	199,169,0
C 	41,159,255

111111111111111111
100100000000000001
100100000000100001
100000010E00D00001
100100000000100001
100100000000000001
111111111111111111
