NO textures/SO.xpm
SO textures/SO.xpm
WE textures/SO.xpm
EA textures/SO.xpm

F 0,0,0
C 20,20,20

11111111111111111111111111111111111111111111111111111111111111111111111
110000000010000000100000000100000001000000001000000010000000010000000N1
11011111101000000110111111010000001101111110100000011011111101000000101
11010000000000000110100000000000001101000000000000011010000000000000101
11010000000000000110100000000000001101000000000000011010000000000000101
11010000010000000110100000100000001101000001000000011010000010000000101
11000000010000000110000000100000001100000001000000011000000010000000101
10000000001000000011000000010000000110000000100000001100000001000000101
11000000010000000110000000100000001100000001000000011000000010000000101
11000000010000000110000000100000001100000001000000011000000010000000101
11011111110000010010111111100000100101111111000001001011111110000010001
11000000000000010110000000000000101100000000000001011000000000000010101
11000000000000010000000000000001000000000000000100000000000000010100001
11000111111111110110001111111111101100011111111111011000111111111110101
11000100010000000110001000100000001100010001000000011000100010000000101
10000100010100010100001000101000101000010001010001010000100010100010101
11110100000101010011101000001010100111010000010101001110100000101010011
11110101000101010111101010001010101111010100010101011110101000101010101
11110001010101010111100010101010101111000101010101011110001010101010101
10110101010101010101101010101010101011010101010101010110101010101010101
10100101010001010101001010100010101010010101000101010100101010001010101
10100001011111010101000010111110101010000101111101010100001011111010101
10101111000000010101011010000000101010111100000001010101011000000010101
10101001111111010101010011111110101010100111111101010101001111111010101
10101000000000010001010000000000100010100000000001000101000000000010001
11111111111111111111111111111111111111111111111111111111111111111111111
